111111111111111111111111111111
111111000000000000000000000001
110000000000000000000000000001
110000000000000000000000000001
110000000000000000000000000001
110000000000000000000000000001
100000000000000000000000000001
100000000000000000000000110001
100000000000000000000000110011
100000000000000000000000000001
100000000000000000000000000001
100000000000000000000000000001
100000000000000000000000000001
100000000000001000000000000001
100000000000000000000000000001
100000000000000000000000000001
100000000000000000000000000001
100000000000000000000000000001
100000000000000000000000000001
100000000000000000000000000001
100000000000000000000000000001
100001111100000000000111110001
100000000000000000000000000001
100000000000000000000000000001
100000000000000000000000000001
100000000000000000000000000001
100000000000000000000000000001
100000000000000000000000000001
100000000000000000000000000001
111111111111111111111111111111
